- - - - - - - - - - - - - - - - - W - - - - - - - - - - - - - - - - - - - - - - - - - - - - - - - - - - - - - - - - - - - - - - - - - - - - - - - - - - - - - - - - - - - - - - - - - - - - - - - - - - - - - - - - - - - - - - - - - - - - - - - - - - - - - - - - - - - - - - - - - - - - - - - - - - - - - W
- - - - - - - - - - - - - - - - - W - - - - - - - - - - - - - - - - - - - - - - - - - - - - - - - - - - - - - - - - - - - - - - - - - - - - - - - - - - - - - - - - - - - - - - - - - - - - - - - - - - - - - - - - - - - - - - - - - - - - - - - - - - - - - - - - - - - - - - - - - - - - - - - - - - - - - W
- - - - - - - - - - - - - - - - - W - - - - - - - - - - - - - - - - - - - - - - - - - - - - - - - - - - - - - - - - - - - - - - - - - - - - - - - - - - - - - - - - - - - - - - - - - - - - - - - - - - - - - - - - - - - - - - - - - - - - - - - - - - - - - - - - - - - - - - - - - - - - - - - - - - - - - W
- - - - - - - - - - - - - - - - - W - - - - - - - - - - - - - - - - - - - - - - - - - - - - - - - - - - - - - - - - - - - - - - - - - - - - - - - - - - - - - - - - - - - I - - - - - - - - - - - - - - - - - - - - - - - - - - - - - - - - - - - - - - - - - - - - - - - - - - - - - - - - - - - - - - - - - W
- - - - - - - - - - - - - - - - - W - - - - - - - - - - - - - - - - - - - - - - - - - - - - - - - - - - - - - - - - - - - - - - - - - - - - - - - - - - - - - - - G F F F F F F F F F G - - - - - - - - - - - - - - - - - - - - - - - - - - - - - - - - - - - - - - - - - - - - - - - - - - - - - - - - - - - W
- - - - - - - - - - - - - - - - - W - - - - - - - - - - - - - - - - - - - - - - - - - - - - - - - - - - - - - - - - - - - - - - - - - - - - - - - - - - - - - - - - - ^ - - - - - ^ - - - - - - - - - - - - - - - - - - - - - - - - - - - - - - - - - - - - - - - - - - - - - - - - - - - - - - - - - - - - - W
- - - - - - - - - - - - - - - - - W - - - - - - - - - - - - - - - - - - - - - - - - - - - - G F F F F F F F F F F F F F G - - - - - - - - - - - - - - - - - - - - - - ^ - - - - - ^ - - - - - - - - - - - - - - - - - - - - - - - - - - - - - - - - - - - - - - - - - - - - - - - - - - - - - - - - - - - - - W
- - - - - - - - - - - - - - - - - W - - - - - - - - - - - - - - - - - - - - - - - - - - - - - - ^ - - - - - - - - - ^ - - - - - - - - - - - - - - - - - - - - - - - - ^ - - - - - G F F F F F F G - - - - - - - - - - - - - - - - - - - - - - - - - - - - - - - - - - - - - - - - - - - - - - - - - - - - - - W
- - - - - - - - - - - - - - - - - W - - - - - - - - - - - - - - - - - - - - - - - - - - - - - - ^ - - - - - - - - - ^ - B - - - - - - - - - - - - - - - - - - - - - - ^ - - - - - w - - - - - - W - - - - - - - - - - - - - - - - - - - - - - - - - - - - - - - - - - - - - - - - - - - - - - - - - - - - - - W
- - - - - - - - - - - - - - - - - W - - - - - - - - - - - - - - - - - - - - - - - - - - - - - - ^ - - - - - - - - - ^ - - - - - - - - - - - - - - - - - - - - - - - - ^ - - - - - w - - - - - - W - - - - - - - - - - - - - - - - - - - - - - - - - - - - - - - - - - - - - - - - - - - - - - - - - - - - - - W
- - - - - - - - - - - - - - - - - W - - - - - - - - - - - - - - - - - - - - G F F F F F F F F F F F G - - - - G F F F F F F F F F F F F F F F F F F F G - - - - - - - ^ - - - G F - - - - - - - W - - - - - - - - - - - - - - - - - - - - - - - - - - - - - - - - - - - - - - - - - - - - - - - - - - - - - - W
- - - - - - - - - - - - - - - - - W - - - @ - - - - - - - - - - - - - - - - w - - - - - - - - - - - W - - - - w - - - - - - - - - - - - - - - - - - - W - - - - - - - ^ - - - w - - - - - - - - - F F F F F G - - - - - - - - - - - - - - - - - - - - - - - - - - - - - - - - - - - - - - - - - - - - - - - - W
- - - - - - - - - - - - - - - - - W - - - - - - - - - - - - - - - - - - - - w - - - - - - - - - - - W - - - - w - - - - - - - - - - - - - - - - - - - W - - - - - - - ^ - - - w - - - - - - - - - - - - - - W - - - - - - - - - - - - - - - - - - - - - - - - - - - - - - - - - - - - - - - - - - - - - - - - W
- - - - - - - - - - - - - - - - - W - - - - - - - - - - - - - - - - G F F F - - - - - - - - - - - - W - - - - w - - - - - - - - - - - - - - - - - - - W - - - - - - - ^ - - - w - - - - - - - - - - - - - - W - - - - - - - - - - - - - - - - - - - - - - - - - - - - - - - - - - - - - - - - - - - - - - - - W
- - - - - - - - - - - - - - - - - W - - - - - - - - - - - - - - - - w - - - - - - - - - - - - - - - W - - - - w - - - - - - - - - - - - - - - - - - - W - - - - - - - ^ G F F - - - - - - - - - - - - - - - - F G - - - - - - - - - - - - - - - - - - - - - - - - - - - - - - - - - - - - - - G F F F F F F F G
- - - - - - - - - - - - - - - - - W - - - - - - - - - - - - - - - - w - - - - - - - - - - - - - - - W - - - - w - - - - - - - - - - - - - - - - - - - W - - - - - - - ^ w - - - - - - - - - - - - - - - - - - - W - - - - - - - - - - - - - - - - - - - - - - - - - - - - - - - - - - - - - - w * * * * * * * W
- - - - - - - - - - - - - - - - - W - - - - - - - - - - - - G F F F - - - - - - - - - - - - - - - - W - - - - w - - - - - - - - - - - - - - - - - - - W - - - - - - - ^ w - - - - - - - - - - - - - - - - - - - W - - - - - - - - - - - - - - - - - - - - - - - - - - - - - - - - G F F F F F * * * * * * * * W
- - - - - - - - - - - - - - - - - W - - - P - - - - - - - - w - - - - - - - - - - - - - - - - - - - W - - - - w - - - - - - - - - - - - - - - - - - - W - - - - - G F F - - - - - - - - - - - - - - - - - - - - W - - - - - - - - - - - - - - - - - - - - - - - - - - - - - - - - w * * * * * * * * * * * * * W
- - - - - - - - - - - - - - - - - W - - - - - - - - - - - - w - - - - - - - - - - - - - - - - - - - W - - - - w - - - - - - - - - - - - - - - - - - - W - - - - - w - - - - - - - - - - - - - - - - - - - - - - - F F F G - - - - - - - - - - - - - G F F F F F F G - - - - - - - w * * * * * * * * * * * * * W
- - - - - - - - - - - - - - - - - - F F F F F F F F F F F F - - - - - - - - - - - - - - - - - - - - W - - - - w - - - - - - - - - - - - - - - - - - - W - - - - - w - - - - - - - - - - - - - - - - - - - - - - - - - - W - - - - R R R R R R R - - - - - B - - - - - - - - - - * * * * * * * * * * * * * * * W
- - - - - - - - - - - - - - - - - - - - - - - - - - - - - - - - - - - - - - - - - - - - - - - - - - W - - - - w - - - - - - - - - - - - - - - - - - - W - - - - - w - - - - - - - - - - - - - - - - - - - - - - - - - - W - - - - R R R R R R R - - - - - - - - - - - - - - - - * * * * * * * * * * * * * * * W
- - - - - - - - - - - - - - - - - - - - - - - - - - - - - - - - - - - - - - - - - - - - - - - - - - W - - - - w - - - - - - - - - - - - - - - - - - - - F F F F F - - - - - - - - - - - - - - - - - - - - - - - - - - - - F F F F F F F F F F F F F F F F F F F F F F F F F F F F F F F F F F F F F F F F F F G
- - - - - - - - - - - - - - - - - - - - - - - - - - - - - - - - - - - - - - - - - - - - - - - - - - W - - - - w - - - - - - - - - - - - - - - - - - - - - - - - - - - - - - - - - - - - - - - - - - - - - - - - - - - - - - - - - - - - - - - - - - - - - - - - - - - - - - - - - - - - - - - - - - - - - - - W
- - - - - - - - - - - - - - - - - - - - - - - - - - - - - - - - - - - - - - - - - - - - - - - - - - W - - - - w - - - - - - - - - - - - - - - - - - - - - - - - - - - - - - - - - - - - - - - - - - - - - - - - - - - - - - - - - - - - - - - - - - - - - - - - - - - - - - - - - - - - - - - - - - - - - - - W
- - - - - - - - - - - - - - - - - - - - - - - - - - - - - - - - - - - - - - - - - - - - - - - - - - W - - - - w - - - - - - - - - - - - - - - - - - - - - - - - - - - - - - - - - - - - - - - - - - - - - - - - - - - - - - - - - - - - - - - - - - - - - - - - - - - - - - - - - - - - - - - - - - - - - - - W
